11111111111111111
10110100011101101
10000001000000001
11111111110111101
11100000010110101
10001101000000001
10110101101110101
10110100000000101
10000001011010001
10100010011011111
11110100000000001
10000001010110101
10111100010010111
10100011111000001
10101001011111101
10001000000000101
11111111111111111
